WTLore
Part one of an interactive background story by snowdrop
Release 0 / Serial number 110508 / Inform 7 build 6G60 (I6/v6.32 lib 6/12N) SD

carriage
When boarding the carriage you were impressed by the seemingly high standard in which you would get to travel: It's pitch black construction is heavily decorated with flower resembling golden patterns, it is spacious and of finest standard in every aspect. There are two comfortable wide seats that face each other in it, one of which you occupy. The carriage walls are covered with quilted dark red silk. The door is locked from the outside.

You notice a scroll container lying at the empty seat in front of you.It's of thick leather, looks newly made and hasn't been opened yet judging by the looks of the unbroken seal.

>look
carriage
 The black glossy carriage is heavily decoareted with flower resembling golden patterns, it is spatious and of finest standard in every aspect. There are two comfortable benches that face each other in it, one of which you occupy. The carriage walls are covered with quilted dark red silk, isolated with an unknown material. 

 You notice a scroll container lying at the empty seat in front of you.  It's of thick leather, looks unworn and hasn't been opened yet judging from the unbroken Imperial seal.

>n
You can't go that way.

>s
Castle Entrance room
You find yourself standing in the entrance .  It has a very hight ceiling with what seems to be sections of glass, revealing a clear night. There is a dim light at the east end of the passage.

There is a small wicker cage discarded nearby.

You notice a guestbook that's placed on a podium.

>n
Yard
You have never witnessed such a marvelous garden before.

>n
You can't go that way.

>w
You can't go that way.

>s
Castle Entrance room
You find yourself standing in the entrance .  There is a dim light at the east end of the passage.

There is a small wicker cage discarded nearby.

You notice a guestbook that's placed on a podium.

* * *

>n
You can't go that way.

>l
Yard
You have never witnessed such a marvelous garden before.

>s
You can't go that way.

>w
Castle Hallway room
You find yourself standing in the castle entrance. It has a very high ceiling with what seems to be sections of thick heavy glass, revealing a clear night with stars incognito. There is a dim light at the east end of the passage.

There is a small wicker cage discarded nearby.

>s
You can't go that way.

>n
You can't go that way.

>u
You can't go that way.

>undo
Castle Hallway room
[Previous turn undone.]

>undo
Castle Hallway room
[Previous turn undone.]

>undo
Yard
[Previous turn undone.]

>undo
Yard
[Previous turn undone.]

>restart
Are you sure you want to restart?

>y
WTLore
An Interactive Fiction by snowdrop
Release 1 / Serial number 110422 / Inform 7 build 6G60 (I6/v6.32 lib 6/12N) SD

Yard
You have never witnessed such a marvelous garden before.

* * *

>look
carriage
 The black glossy carriage is heavily decoareted with flower resembling golden patterns, it is spatious and of finest standard in every aspect. There are two comfortable benches that face each other in it, one of which you occupy. The carriage walls are covered with quilted dark red silk, isolated with an unknown material. 

 You notice a scroll container lying at the empty seat in front of you.  It's of thick leather, looks unworn and hasn't been opened yet judging from the unbroken Imperial seal.

>l
Yard
You have never witnessed such a marvelous garden before.

The carriage is parked outside the entrance to the castel. It's heavily decorated with golden ornaments in curved shapes that have the patterns of symmetric vegetation.

>go
You'll have to say which compass direction to go in.

>look s
You see nothing unexpected in that direction.

>look n
You see nothing unexpected in that direction.

>s
Castle Entrance room
You find yourself standing in the entrance .  It has a very hight ceiling with what seems to be sections of glass, revealing a clear night. There is a dim light at the east end of the passage.

There is a small wicker cage discarded nearby.

You notice a guestbook that's placed on a podium.

>examine
What do you want to examine?

>examine castle
You can't see any such thing.

>look
Castle Entrance room
You find yourself standing in the entrance .  There is a dim light at the east end of the passage.

There is a small wicker cage discarded nearby.

You notice a guestbook that's placed on a podium.

* * *

>look
carriage
 The black glossy carriage is heavily decoareted with flower resembling golden patterns, it is spatious and of finest standard in every aspect. There are two comfortable benches that face each other in it, one of which you occupy. The carriage walls are covered with quilted dark red silk, isolated with an unknown material. 

 You notice a scroll container lying at the empty seat in front of you.  It's of thick leather, looks unworn and hasn't been opened yet judging from the unbroken Imperial seal.

>e
Garden
The carriage is small, yet of finest comfort.

* * *

>look
carriage
 The black glossy carriage is heavily decoareted with flower resembling golden patterns, it is spatious and of finest standard in every aspect. There are two comfortable benches that face each other in it, one of which you occupy. The carriage walls are covered with quilted dark red silk, isolated with an unknown material. 

 You notice a scroll container lying at the empty seat in front of you.  It's of thick leather, looks unworn and hasn't been opened yet judging from the unbroken Imperial seal.

>take container
Taken.

>l
carriage
The black carriage in which you arrived in is parked at the side, in front of the entrance. The carriage is small, yet of finest comfort.

>i
You are carrying:
  a scroll container (closed)

>w
You dont want to leave the carriage just yet - there must surely be a good reason for why the scroll container has been placed there, like for instance your orders for the evening events
yard
You have never witnessed such a marvelous garden before.

>l
yard
You have never witnessed such a marvelous garden before.

>e
carriage
The black carriage in which you arrived in is parked at the side, in front of the entrance. The carriage is small, yet of finest comfort.

>drop container
Dropped.

>l
carriage
The black carriage in which you arrived in is parked at the side, in front of the entrance. The carriage is small, yet of finest comfort.

You can see a scroll container (closed) here.

>look at container
It gives an impression of being important due to it wearing the wax sealing with the Imperial sigill. Rumor has it only the emperor, his nearest of kin and a few selected advisors are authorised to use it.  The container is of good craftmanship, a cylindrical shape made of just a single piece of leather to better protect its content in case it would be exposed to water.

>w
You dont want to leave the carriage just yet - there must surely be a good reason for why the scroll container has been placed there, like for instance your orders for the evening events
yard
You have never witnessed such a marvelous garden before.

* * *

>l
yard
You have never witnessed such a marvelous garden before.

>e
carriage
The black carriage in which you arrived in is parked at the side, in front of the entrance. The carriage is small, yet of finest comfort.

You can see a scroll container (closed) here.

>i
You are carrying nothing.

* * *

>look
carriage
 The black glossy carriage is heavily decoareted with flower resembling golden patterns, it is spatious and of finest standard in every aspect. There are two comfortable benches that face each other in it, one of which you occupy. The carriage walls are covered with quilted dark red silk, isolated with an unknown material. 

 You notice a scroll container lying at the empty seat in front of you.  It's of thick leather, looks unworn and hasn't been opened yet judging from the unbroken Imperial seal.

>z
Time passes.

>z
Time passes.

You feel how the carriage is turning in a steep curve, aking you lean into that direction.

>z
Time passes.

>z
Time passes.

You are getting closer by the minute and will soon get to prove yourself.

>z
Time passes.

>z
Time passes.

>z
Time passes.

The carriage wheels rumble over a small hole in the ground.

>z
Time passes.

You are getting closer by the minute and will soon get to prove yourself.

>z
Time passes.

You feel how the carriage is turning in a steep curve, aking you lean into that direction.

* * *

>look
carriage
 The black glossy carriage is heavily decoareted with flower resembling golden patterns, it is spatious and of finest standard in every aspect. There are two comfortable benches that face each other in it, one of which you occupy. The carriage walls are covered with quilted dark red silk, isolated with an unknown material. 

 You notice a scroll container lying at the empty seat in front of you.  It's of thick leather, looks unworn and hasn't been opened yet judging from the unbroken Imperial seal.

>klol
That's not a verb I recognise.

>look
carriage
The black carriage in which you arrived in is parked at the side, in front of the entrance. The carriage is small, yet of finest comfort.

You notice a scroll container lying at the empty seat in front of you. It's of thick leather, looks unworn and hasn't been opened yet judging from the unbroken Imperial seal.

I beg your pardon?

>look
carriage
The black carriage in which you arrived in is parked at the side, in front of the entrance. The carriage is small, yet of finest comfort.

You notice a scroll container lying at the empty seat in front of you. It's of thick leather, looks unworn and hasn't been opened yet judging from the unbroken Imperial seal. 

You feel how the carriage is turning in a steep curve, aking you lean into that direction.

>look
carriage
The black carriage in which you arrived in is parked at the side, in front of the entrance. The carriage is small, yet of finest comfort.

You notice a scroll container lying at the empty seat in front of you. It's of thick leather, looks unworn and hasn't been opened yet judging from the unbroken Imperial seal.

>w
On second thought you don't want to leave the carriage just yet. First you would want to read your orders for the evening events.

yard
You have never witnessed such a marvelous garden before.

>l
yard
You have never witnessed such a marvelous garden before.

>e
There is nothing to the east - your carriage left after you arrived at the castle premises, and you're to self-loving to dare leave before completing your mission.

* * *

>n
You can't go that way.

>north
You can't go that way.

>feel
What do you want to feel?

>touch me
If you think that'll help.

* * *

>l
carriage
It's pitch black construction is heavily decoareted with flower resembling golden patterns, it is spatious and of finest standard in every aspect. There are two comfortable wide seats that face each other in it, one of which you occupy. The carriage walls are covered with quilted dark red silk. The door is locked from the outside.

The scroll container is still here. It's of thick leather, looks newly made and hasn't been opened yet judging by the looks of the unbroken Imperial seal.

>e
You can't go that way.

>w
You decide it's time to fullfill your duties & finally gather courage to leave the carriage
Yard
You have never witnessed such a marvelous garden before.

* * *

>e
You can't go that way.

>c
That's not a verb I recognise.

>w
You decide it's time to fulfil your duties & finally gather courage to leave the carriage
yard
You have never witnessed such a marvelous garden before.

The carriage is shaking back and forth as it finds it's way ahead.

>w
Castle Hallway room
You find yourself standing in the castle entrance. It has a very high ceiling with what seems to be sections of thick heavy glass, revealing a clear night with stars incognito. There is a dim light at the east end of the passage.

There is a small wicker cage discarded nearby.

The carriage is shaking back and forth as it finds it's way ahead.

>e
You decide it's time to fulfil your duties & finally gather courage to leave the carriage
yard
You have never witnessed such a marvelous garden before.

The carriage is shaking back and forth as it finds it's way ahead.

>e
carriage
The black carriage in which you arrived in is parked at the side, in front of the entrance. The carriage is small, yet of finest comfort.

You notice a scroll container lying at the empty seat in front of you. It's of thick leather, looks unworn and hasn't been opened yet judging from the unbroken Imperial seal. 

The carriage is shaking back and forth as it finds it's way ahead.

>exaine
That's not a verb I recognise.

>l
carriage
The black carriage in which you arrived in is parked at the side, in front of the entrance. The carriage is small, yet of finest comfort.

You notice a scroll container lying at the empty seat in front of you. It's of thick leather, looks unworn and hasn't been opened yet judging from the unbroken Imperial seal. 

The carriage is shaking back and forth as it finds it's way ahead.

* * *

>l
carriage
It's pitch black construction is heavily decoareted with flower resembling golden patterns, it is spatious and of finest standard in every aspect. There are two comfortable wide seats that face each other in it, one of which you occupy. The carriage walls are covered with quilted dark red silk. The door is locked from the outside.

The scroll container is still here. It's of thick leather, looks newly made and hasn't been opened yet judging by the looks of the unbroken Imperial seal.

>e scroll
I only understood you as far as wanting to e.

>examine scroll container
It gives an impression of being important due to it wearing the wax sealing with the Imperial sigill. Rumor has it only the emperor, his nearest of kin and a few selected advisors are authorised to use it.  The container is of good craftmanship, a cylindrical shape made of just a single piece of leather to better protect its content in case it would be exposed to water.

>l
carriage
The black carriage in which you arrived in is parked at the side, in front of the entrance. The carriage is small, yet of finest comfort.

You notice a scroll container lying at the empty seat in front of you. It's of thick leather, looks unworn and hasn't been opened yet judging from the Imperial seal that is unbroken.

>examine scroll container
It gives an impression of being important due to it wearing the wax sealing with the Imperial sigill. Rumor has it only the emperor, his nearest of kin and a few selected advisors are authorised to use it.

* * *

>l
carriage
It's pitch black construction is heavily decoareted with flower resembling golden patterns, it is spatious and of finest standard in every aspect. There are two comfortable wide seats that face each other in it, one of which you occupy. The carriage walls are covered with quilted dark red silk. The door is locked from the outside.

The scroll container is still here. It's of thick leather, looks newly made and hasn't been opened yet judging by the looks of the unbroken Imperial seal.

>open scroll continaer
I only understood you as far as wanting to open the scroll container.

>open scroll
You open the scroll container, revealing a thing named scroll.

>i
You are carrying nothing.

* * *

>l
carriage
It's pitch black construction is heavily decoareted with flower resembling golden patterns, it is spatious and of finest standard in every aspect. There are two comfortable wide seats that face each other in it, one of which you occupy. The carriage walls are covered with quilted dark red silk. The door is locked from the outside.

The scroll container is still here. It's of thick leather, looks newly made and hasn't been opened yet judging by the looks of the unbroken Imperial seal.

>l
carriage
 It's night black construction is heavily decoareted with flower resembling golden patterns, it is spatious and of finest standard in every aspect. There are two comfortable benches that face each other in it, one of which you occupy. The carriage walls are covered with quilted dark red silk, isolated with an unknown material. 

You notice a scroll container lying at the empty seat in front of you.  It's of thick leather, looks newly made and hasn't been opened yet judging by the looks of the unbroken Imperial seal.

>l / L /l
You can't see any such thing.

>l
carriage
The black carriage in which you arrived in is parked at the side, in front of the entrance. The carriage is small, yet of finest comfort.

You notice a scroll container lying at the empty seat in front of you. It's of thick leather, looks unworn and hasn't been opened yet judging from the unbroken Imperial seal.

>l
carriage
The black carriage in which you arrived in is parked at the side, in front of the entrance. The carriage is small, yet of finest comfort.

You notice a scroll container lying at the empty seat in front of you. It's of thick leather, looks unworn and hasn't been opened yet judging from the unbroken Imperial seal.

>l
carriage
The black carriage in which you arrived in is parked at the side, in front of the entrance. The carriage is small, yet of finest comfort.

You notice a scroll container lying at the empty seat in front of you. It's of thick leather, looks unworn and hasn't been opened yet judging from the unbroken Imperial seal. 

You feel how the carriage is turning in a steep curve, aking you lean into that direction.

>l
carriage
The black carriage in which you arrived in is parked at the side, in front of the entrance. The carriage is small, yet of finest comfort.

You notice a scroll container lying at the empty seat in front of you. It's of thick leather, looks unworn and hasn't been opened yet judging from the unbroken Imperial seal.

>l
carriage
The black carriage in which you arrived in is parked at the side, in front of the entrance. The carriage is small, yet of finest comfort.

You notice a scroll container lying at the empty seat in front of you. It's of thick leather, looks unworn and hasn't been opened yet judging from the unbroken Imperial seal. 

You are getting closer by the minute and will soon get to prove yourself.

>l
carriage
The black carriage in which you arrived in is parked at the side, in front of the entrance. The carriage is small, yet of finest comfort.

You notice a scroll container lying at the empty seat in front of you. It's of thick leather, looks unworn and hasn't been opened yet judging from the unbroken Imperial seal. 

The carriage wheels rumble over a small hole in the ground.

>w
On second thought you don't want to leave the carriage just yet. First you would want to read your orders for the evening events.

yard
You have never witnessed such a marvelous garden before.

* * *

>e
There is nothing to the east - your carriage left after you arrived at the castle premises, and you're to self-loving to dare leave before completing your mission.

>l
yard
You have never witnessed such a marvelous garden before.

* * *

>l
carriage
 It's night black construction is heavily decoareted with flower resembling golden patterns, it is spatious and of finest standard in every aspect. There are two comfortable benches that face each other in it, one of which you occupy. The carriage walls are covered with quilted dark red silk, isolated with an unknown material. 

You notice a scroll container lying at the empty seat in front of you.  It's of thick leather, looks newly made and hasn't been opened yet judging by the looks of the unbroken Imperial seal.

>examine container
It gives an impression of being important due to it wearing the wax sealing with the Imperial sigill. Rumor has it only the emperor, his nearest of kin and a few selected advisors are authorised to use it.  The container is of good craftmanship, a cylindrical shape made of just a single piece of leather to better protect its content in case it would be exposed to water.

>l
carriage
When boarding the carriage eariler today you were impressed by the high standard in which you would get to travel: The black glossy carriage is heavily decoareted with flower resembling golden patterns, it is spatious and of finest standard in every aspect. There are two comfortable benches that face each other in it, one of which you occupy. The carriage walls are covered with quilted dark red silk, isolated with an unknown material. 

The scroll container is still here. It's of thick leather, looks unworn and hasn't been opened yet judging from the unbroken Imperial seal. 

Will this journey never end?

* * *

>l
carriage
 It's night black construction is heavily decoareted with flower resembling golden patterns, it is spatious and of finest standard in every aspect. There are two comfortable benches that face each other in it, one of which you occupy. The carriage walls are covered with quilted dark red silk, isolated with an unknown material. 

You notice a scroll container lying at the empty seat in front of you.  It's of thick leather, looks newly made and hasn't been opened yet judging by the looks of the unbroken Imperial seal.

>l
carriage
 It's night black construction is heavily decoareted with flower resembling golden patterns, it is spatious and of finest standard in every aspect. There are two comfortable benches that face each other in it, one of which you occupy. The carriage walls are covered with quilted dark red silk, isolated with an unknown material. 

You notice a scroll container lying at the empty seat in front of you.  It's of thick leather, looks newly made and hasn't been opened yet judging by the looks of the unbroken Imperial seal. 

Will this journey never end? Time goes slowly by.

>l
carriage
When boarding the carriage eariler today you were impressed by the high standard in which you would get to travel: The black glossy carriage is heavily decoareted with flower resembling golden patterns, it is spatious and of finest standard in every aspect. There are two comfortable benches that face each other in it, one of which you occupy. The carriage walls are covered with quilted dark red silk, isolated with an unknown material. 

 You notice a scroll container lying at the empty seat in front of you.  It's of thick leather, looks unworn and hasn't been opened yet judging from the unbroken Imperial seal.

* * *

>l
carriage
 It's night black construction is heavily decoareted with flower resembling golden patterns, it is spatious and of finest standard in every aspect. There are two comfortable benches that face each other in it, one of which you occupy. The carriage walls are covered with quilted dark red silk, isolated with an unknown material. 

You notice a scroll container lying at the empty seat in front of you.  It's of thick leather, looks newly made and hasn't been opened yet judging by the looks of the unbroken Imperial seal. 

Will this journey never end? Time goes slowly by.

I beg your pardon?

>l
carriage
 It's night black construction is heavily decoareted with flower resembling golden patterns, it is spatious and of finest standard in every aspect. There are two comfortable benches that face each other in it, one of which you occupy. The carriage walls are covered with quilted dark red silk, isolated with an unknown material. 

You notice a scroll container lying at the empty seat in front of you.  It's of thick leather, looks newly made and hasn't been opened yet judging by the looks of the unbroken Imperial seal.

>examine container
It gives an impression of being important due to it wearing the wax sealing with the Imperial sigill. Rumor has it only the emperor, his nearest of kin and a few selected advisors are authorised to use it. The container is of good craftmanship. It has a cylindrical shape made of just a single piece of leather to better protect its content in case it would be exposed to water. 

The carriage wheels rumble over a small hole in the ground.

>l
carriage
 It's night black construction is heavily decoareted with flower resembling golden patterns, it is spatious and of finest standard in every aspect. There are two comfortable benches that face each other in it, one of which you occupy. The carriage walls are covered with quilted dark red silk, isolated with an unknown material. 

The scroll container is still here. It's of thick leather, looks newly made and hasn't been opened yet judging by the looks of the unbroken Imperial seal. 

You feel how the carriage is turning in a steep curve, making you lean into that direction.

>think
What a good idea.

>remember
That's not a verb I recognise.

* * *

>l
carriage
It's pitch black construction is heavily decoareted with flower resembling golden patterns, it is spatious and of finest standard in every aspect. There are two comfortable wide seats that face each other in it, one of which you occupy. The carriage walls are covered with quilted dark red silk. The door is locked from the outside.

The scroll container is still here. It's of thick leather, looks newly made and hasn't been opened yet judging by the looks of the unbroken Imperial seal.

>w
You can't go that way.

>help
 > Introduction to WTLore
   Instructions for Play
   Hints
   Settings
   Contacting the author

   Introduction to WTLore
 > Instructions for Play
   Hints
   Settings
   Contacting the author
   Introduction to WTLore
 > Instructions for Play
   Hints
   Settings
   Contacting the author

   Introduction to WTLore
   Instructions for Play
 > Hints
   Settings
   Contacting the author
   Introduction to WTLore
   Instructions for Play
 > Hints
   Settings
   Contacting the author

   Introduction to WTLore
   Instructions for Play
   Hints
 > Settings
   Contacting the author
   Introduction to WTLore
   Instructions for Play
   Hints
 > Settings
   Contacting the author

   Introduction to WTLore
   Instructions for Play
 > Hints
   Settings
   Contacting the author
   Introduction to WTLore
   Instructions for Play
 > Hints
   Settings
   Contacting the author

>m
   Introduction to WTLore
   Instructions for Play
 > Hints
   Settings
   Contacting the author

>m
   Introduction to WTLore
   Instructions for Play
 > Hints
   Settings
   Contacting the author

>n
   Introduction to WTLore
   Instructions for Play
   Hints
 > Settings
   Contacting the author
   Introduction to WTLore
   Instructions for Play
   Hints
 > Settings
   Contacting the author

>o
   Introduction to WTLore
   Instructions for Play
   Hints
 > Settings
   Contacting the author

>o
   Introduction to WTLore
   Instructions for Play
   Hints
 > Settings
   Contacting the author

   Introduction to WTLore
   Instructions for Play
 > Hints
   Settings
   Contacting the author
   Introduction to WTLore
   Instructions for Play
 > Hints
   Settings
   Contacting the author

 > What do I do with the string?

 > What do I do with the string?
 > What do I do with the string?

 > What do I do with the string?
 > What do I do with the string?

1/2: Remember that you know how to macrame.

Press SPACE to return to the menu or H to reveal another hint.

 > What do I do with the string?
 > What do I do with the string?

* * *

1/2: Remember that you know how to macrame.

Press SPACE to return to the menu or H to reveal another hint.

>h
1/2: Remember that you know how to macrame.

2/2: Oh, come now, isn't it obvious?

Press SPACE to return to the menu.

 > What do I do with the string?
 > What do I do with the string?

>q
   Introduction to WTLore
   Instructions for Play
 > Hints
   Settings
   Contacting the author

>q
yard
You have never witnessed such a marvelous garden before.

* * *

>w
You can't go that way.

>l
carriage
When boarding the carriage eariler today you were impressed by the high standard in which you would get to travel: The black glossy carriage is heavily decoareted with flower resembling golden patterns, it is spatious and of finest standard in every aspect. There are two comfortable benches that face each other in it, one of which you occupy. The carriage walls are covered with quilted dark red silk, isolated with an unknown material. 

 You notice a scroll container lying at the empty seat in front of you.  It's of thick leather, looks unworn and hasn't been opened yet judging from the unbroken Imperial seal. 

You're bored by the long travels and have a tense feeling.

>z
Time passes.

>z
Time passes.

Will this journey never end? Time goes slowly by.

>z
Time passes.

The carriage wheels rumble over a small hole in the ground.

I beg your pardon?

>z
Time passes.

You feel how the carriage is turning in a steep curve, making you lean into that direction.

>z
Time passes.

The sound from the fast turning carriage wheels makes it hard to focus.

I beg your pardon?

>z
Time passes.

>open container
You open the scroll container, revealing a letter.

>l
carriage
When boarding the carriage eariler today you were impressed by the high standard in which you would get to travel: The black glossy carriage is heavily decoareted with flower resembling golden patterns, it is spatious and of finest standard in every aspect. There are two comfortable benches that face each other in it, one of which you occupy. The carriage walls are covered with quilted dark red silk, isolated with an unknown material. 

 You notice a scroll container lying at the empty seat in front of you.  It's of thick leather, looks unworn and the Imperial seal on it has been broken.

>close container
You close the scroll container.

>l
carriage
When boarding the carriage eariler today you were impressed by the high standard in which you would get to travel: The black glossy carriage is heavily decoareted with flower resembling golden patterns, it is spatious and of finest standard in every aspect. There are two comfortable benches that face each other in it, one of which you occupy. The carriage walls are covered with quilted dark red silk, isolated with an unknown material. 

 You notice a scroll container lying at the empty seat in front of you.  It's of thick leather, looks unworn and the Imperial seal on it has been broken.

The horses make you rock slightly back and forth..

* * *

>l
carriage
It's pitch black construction is heavily decoareted with flower resembling golden patterns, it is spatious and of finest standard in every aspect. There are two comfortable wide seats that face each other in it, one of which you occupy. The carriage walls are covered with quilted dark red silk. The door is locked from the outside.

The scroll container is still here. It's of thick leather, looks newly made and hasn't been opened yet judging by the looks of the unbroken Imperial seal.

>examine container
It gives an impression of being important due to it wearing the wax sealing with the Imperial sigill. Rumor has it only the emperor, his nearest of kin and a few selected advisors are authorised to use it.  The container is of good craftmanship, a cylindrical shape made of just a single piece of leather to better protect its content in case it would be exposed to water. 

You're both tense and bored.

>openb contariner
That's not a verb I recognise.

>open contariner
You can't see any such thing.

>open container
You open the scroll container, revealing a letter.

>take letter
Taken.

>i
You are carrying:
  a letter

>look
carriage
When boarding the carriage eariler today you were impressed by the high standard in which you would get to travel: The black glossy carriage is heavily decoareted with flower resembling golden patterns, it is spatious and of finest standard in every aspect. There are two comfortable benches that face each other in it, one of which you occupy. The carriage walls are covered with quilted dark red silk, isolated with an unknown material. 

You notice a scroll container lying at the empty seat in front of you. It's of thick leather, looks unworn and the Imperial seal on it has been broken.

* * *

>l
carriage
It's pitch black construction is heavily decoareted with flower resembling golden patterns, it is spatious and of finest standard in every aspect. There are two comfortable wide seats that face each other in it, one of which you occupy. The carriage walls are covered with quilted dark red silk. The door is locked from the outside.

The scroll container is still here. It's of thick leather, looks newly made and hasn't been opened yet judging by the looks of the unbroken Imperial seal.

>\tl
That's not a verb I recognise.

>l
carriage
When boarding the carriage eariler today you were impressed by the high standard in which you would get to travel: The black glossy carriage is heavily decoareted with flower resembling golden patterns, it is spatious and of finest standard in every aspect. There are two comfortable benches that face each other in it, one of which you occupy. The carriage walls are covered with quilted dark red silk, isolated with an unknown material. 

 You notice a scroll container lying at the empty seat in front of you.  It's of thick leather, looks unworn and hasn't been opened yet judging from the unbroken Imperial seal.

>examine carriage
You can't see any such thing.

>look
carriage
When boarding the carriage eariler today you were impressed by the high standard in which you would get to travel: The black glossy carriage is heavily decoareted with flower resembling golden patterns, it is spatious and of finest standard in every aspect. There are two comfortable benches that face each other in it, one of which you occupy. The carriage walls are covered with quilted dark red silk, isolated with an unknown material. 

 You notice a scroll container lying at the empty seat in front of you.  It's of thick leather, looks unworn and hasn't been opened yet judging from the unbroken Imperial seal. 

You're both tense and bored.

* * *

>l
carriage
It's pitch black construction is heavily decoareted with flower resembling golden patterns, it is spatious and of finest standard in every aspect. There are two comfortable wide seats that face each other in it, one of which you occupy. The carriage walls are covered with quilted dark red silk. The door is locked from the outside.

The scroll container is still here. It's of thick leather, looks newly made and hasn't been opened yet judging by the looks of the unbroken Imperial seal.

>open container
The carriage is finally beginning to slow down as you reach for the scroll container. The broken wax falls of in small pieces on the seat. Seeing this, you hesitate a moment, as if the container wasn't meant for you eben though you know it is. It was placed there by trusted messenger, the word directly sent from the court of his Imperial highness. 

You think about it for a second and realise you stopped for a moment not because you would violate the law of secrecy by resting eyes where they didn't belong, but because you know how important the content of the container is.

Your orders are in the container, waiting to be read.

>l
carriage
 It's pitch black construction is heavily decoareted with flower resembling golden patterns, it is spatious and of finest standard in every aspect. There are two comfortable wide seats that face each other in it, one of which you occupy. The carriage walls are covered with quilted dark red silk. The door is locked from the outside.

On the seat there are a couple of small thick red wax pieces that used to make up the seal of the scroll container. They're the remainder of the sigill, which is beyond recognition.

The scroll container is still here. It's of thick leather, looks newly made and is open. The Imperial seal on it is broken.

>examine container
It gives an impression of being important due to it wearing the wax sealing with the Imperial sigill. Rumor has it only the emperor, his nearest of kin and a few selected advisors are authorised to use it. The container is of good craftmanship. It has a cylindrical shape made of just a single piece of leather to better protect its content in case it would be exposed to water. 

In the scroll container is a letter.

>take wax
Taken.

>i
You are carrying:
  some sigill wax pieces

* * *

>l
carriage
It's pitch black construction is heavily decoareted with flower resembling golden patterns, it is spatious and of finest standard in every aspect. There are two comfortable wide seats that face each other in it, one of which you occupy. The carriage walls are covered with quilted dark red silk. The door is locked from the outside.

The scroll container is still here. It's of thick leather, looks newly made and hasn't been opened yet judging by the looks of the unbroken Imperial seal.

>open scroll
The carriage is finally beginning to slow down as you reach for the scroll container. The broken wax falls of it in small pieces on the seat. Seeing this, you hesitate a moment, as if the container wasn't meant for you even though you know it is. It was placed there by trusted messenger, the word directly sent from the court of his Imperial highness. 

You think about it for a second and realise you stopped for a moment not because you would violate the law of secrecy by resting eyes where they didn't belong, but because you know how important the content of the container is.

Your orders are in the container, waiting to be read.

>l
carriage
It's pitch black construction is heavily decoareted with flower resembling golden patterns, it is spatious and of finest standard in every aspect. There are two comfortable wide seats that face each other in it, one of which you occupy. The carriage walls are covered with quilted dark red silk. The door is locked from the outside.

On the seat there's a red piece of wax. It used to guarantee the authenticity of the msg, but is just smudgy filth now.

The scroll container is still here. It's of thick leather, looks newly made and is open. The Imperial seal on it is broken.

>take wax
Taken.

>l
carriage
It's pitch black construction is heavily decoareted with flower resembling golden patterns, it is spatious and of finest standard in every aspect. There are two comfortable wide seats that face each other in it, one of which you occupy. The carriage walls are covered with quilted dark red silk. The door is locked from the outside.

The scroll container is still here. It's of thick leather, looks newly made and is open. The Imperial seal on it is broken.

* * *

>look at dossier
Yellow parchment pages, red sigil

>examine it
Yellow parchment pages, red sigil

>look
carriage
The black carriage in which you arrived in is parked at the side, in front of the enrance. The carriage is small, yet of finest comfort.

You notice dossier lying at the empty seat in front of you. It's thick, looks new and hasn't been read yeat judging from the Imperial seal that is unbroken.

>take dossier
Taken.

>look
carriage
The black carriage in which you arrived in is parked at the side, in front of the enrance. The carriage is small, yet of finest comfort.

>i
You are carrying:
  a dossier

>drop i
You can't see any such thing.

>drop dossier
Dropped.

>l
carriage
The black carriage in which you arrived in is parked at the side, in front of the enrance. The carriage is small, yet of finest comfort.

You can see a dossier here.

>look
carriage
The black carriage in which you arrived in is parked at the side, in front of the enrance. The carriage is small, yet of finest comfort.

You can see a dossier here.

>look dossier
Yellow parchment pages, red sigil

>look
carriage
The black carriage in which you arrived in is parked at the side, in front of the enrance. The carriage is small, yet of finest comfort.

You can see a dossier here.

* * *

>look container
It gives an impression of being important due to it wearing the red sigill of wax. The container is of a cylindrical shape and made of just a single piece of leather to better protect its content in case it would be exposed to water.

>look container
 The container is of a cylindrical shape and made of just a single piece of leather to better protect its content in case it would be exposed to water.

* * *

>l container
It gives an impression of being important due to it wearing the wax sealing with the Imperial sigill. Rumor has it only the emperor, his nearest of kin and a few selected advisors are authorised to use it. The container is of good craftmanship. It has a cylindrical shape made of just a single piece of leather to better protect its content in case it would be exposed to water. 

You're bored by the long travels and have a tense feeling.

>l container
It gives an impression of being important due to it wearing the wax sealing with the Imperial sigill. Rumor has it only the emperor, his nearest of kin and a few selected advisors are authorised to use it.

>l
carriage
The black carriage in which you arrived in is parked at the side, in front of the entrance. The carriage is small, yet of finest comfort.

You notice a scroll container lying at the empty seat in front of you. It's of thick leather, looks unworn and hasn't been opened yet judging from the Imperial seal that is unbroken.

>take scroll
Taken.

>l
carriage
The black carriage in which you arrived in is parked at the side, in front of the entrance. The carriage is small, yet of finest comfort.

>i
You are carrying:
  a scroll container

>look at scroll container
It gives an impression of being important due to it wearing the wax sealing with the Imperial sigill. Rumor has it only the emperor, his nearest of kin and a few selected advisors are authorised to use it.

>open scroll container
That's not something you can open.

>open scroll
That's not something you can open.

* * *

>l container
It gives an impression of being important due to it wearing the wax sealing with the Imperial sigill. Rumor has it only the emperor, his nearest of kin and a few selected advisors are authorised to use it. The container is of good craftmanship. It has a cylindrical shape made of just a single piece of leather to better protect its content in case it would be exposed to water. 

You're bored by the long travels and have a tense feeling.

>open container
 The carriage is finally beginning to slow down as you reach for the scroll container. You hesitate a moment, as if it wasn't meant for you but you know it is. It was placed there by trusted messenger, the word directly sent from the court of his Imperial highness. 

You think about it for a second and realise you stopped for a moment not because you would violate the law of secrecy by resting eyes where they didn't belong, but because you know how important the content of the container is.

Your orders are in the container, waiting to be read.

>take orders
Taken.

>l container
It gives an impression of being important due to it wearing the wax sealing with the Imperial sigill. Rumor has it only the emperor, his nearest of kin and a few selected advisors are authorised to use it.

>open container
That's already open.

>close container
You close the scroll container.

Will this journey never end? Time goes slowly by.

>open container
 The carriage is finally beginning to slow down as you reach for the scroll container. You hesitate a moment, as if it wasn't meant for you but you know it is. It was placed there by trusted messenger, the word directly sent from the court of his Imperial highness. 

You think about it for a second and realise you stopped for a moment not because you would violate the law of secrecy by resting eyes where they didn't belong, but because you know how important the content of the container is.

 It is empty.

* * *

>open scroll
The carriage is finally beginning to slow down as you reach for the scroll container. The broken wax falls of in small pieces on the seat. Seeing this, you hesitate a moment, as if the container wasn't meant for you eben though you know it is. It was placed there by trusted messenger, the word directly sent from the court of his Imperial highness. 

You think about it for a second and realise you stopped for a moment not because you would violate the law of secrecy by resting eyes where they didn't belong, but because you know how important the content of the container is.

Your orders are in the container, waiting to be read.

>open scroll container
That's not something you can open.

* * *

>l
carriage
It's pitch black construction is heavily decoareted with flower resembling golden patterns, it is spatious and of finest standard in every aspect. There are two comfortable wide seats that face each other in it, one of which you occupy. The carriage walls are covered with quilted dark red silk. The door is locked from the outside.

On the seat there are a couple of small thick red wax pieces that used to make up the seal of the scroll container. They're the remainder of the sigill, which is beyond recognition.

The scroll container is still here. It's of thick leather, looks newly made and is open. The Imperial seal on it is broken.

* * *

>open container
The carriage is finally beginning to slow down as you reach for the scroll container. The broken wax falls of it in small pieces on the seat. Seeing this, you hesitate a moment, as if the container wasn't meant for you even though you know it is. It was placed there by trusted messenger, the word directly sent from the court of his Imperial highness. 

You think about it for a second and realise you stopped for a moment not because you would violate the law of secrecy by resting eyes where they didn't belong, but because you know how important the content of the container is.

Your orders are in the container, waiting to be read.

>l
carriage
 It's pitch black construction is heavily decoareted with flower resembling golden patterns, it is spatious and of finest standard in every aspect. There are two comfortable wide seats that face each other in it, one of which you occupy. The carriage walls are covered with quilted dark red silk. The door is locked from the outside.

A couple of thick red wax pieces that used to make up the seal of the scroll container. They're sigill is beyond recognition.

You notice a scroll container lying at the empty seat in front of you.  It's of thick leather, looks newly made and is open. The Imperial seal on it is broken.

>look at container
It gives an impression of being important due to it wearing the wax sealing with the Imperial sigill. Rumor has it only the emperor, his nearest of kin and a few selected advisors are authorised to use it.  The container is of good craftmanship, a cylindrical shape made of just a single piece of leather to better protect its content in case it would be exposed to water. 

In the scroll container is a letter.

>look at container
It gives an impression of being important due to it wearing the wax sealing with the Imperial sigill. Rumor has it only the emperor, his nearest of kin and a few selected advisors are authorised to use it. 

In the scroll container is a letter.

* * *

>list
That's not a verb I recognise.

>take wax
You can't see any such thing.

* * *

>take pieces
Taken.

>i
You are carrying:
  a sigill wax pieces

>drop wax
Dropped.

>take sigill
Taken.

>i
You are carrying:
  a sigill wax pieces

* * *

>take letter
Taken.

>w
On second thought you don't want to leave the carriage just yet. First you would want to read your orders for the evening events. 
You're both tense and bored.

* * *

>look container
It gives an impression of being important due to it wearing the wax sealing with the Imperial sigill. Rumor has it only the emperor, his nearest of kin and a few selected advisors are authorised to use it. The container is of good craftmanship. It has a cylindrical shape made of just a single piece of leather to better protect its content in case it would be exposed to water. 

In the scroll container is a letter.

* * *

>exaine container
That's not a verb I recognise.

>exaine container
That's not a verb I recognise.

>examine container
It gives an impression of being important due to it having worn the sigill. Rumor has it only the emperor, his nearest of kin and a few selected advisors are authorised to use it. The container is of good craftmanship. It has a cylindrical shape made of just a single piece of leather to better protect its content in case it would be exposed to water. 

In the scroll container is a letter.

>examine letter
Your mission is... TODO | Letter text here, outlining some of the initial missions the reader will get.

Ending the reading of the letter you realise the horses have halted. You have arrived.

It's time to perform the role of your life. You couldn't believe it when it happened: The huge honour, to be chosen for the task at hand. This would surely be the single most important assignment you could have dreamt of ever getting.

You memorise the content of the letter and make sure to carefully tear it into tiny random pieces beyond recognition. As you open the door you discard them in the evening breez while stepping down onto the sand.

The carriage starts moving again, this time with no passenger onboard other than the empty container left behind by you. You can't help wondering if this was your last ride given the dangers that lay ahead, if it is the final destination you would ever reach.

Yard
There are three fountains here in a row.

>restart
Are you sure you want to restart?

>y
WTLore
Part one of an interactive background story by snowdrop
Release 0 / Serial number 110508 / Inform 7 build 6G60 (I6/v6.32 lib 6/12N) SD

carriage
When boarding the carriage you were impressed by the seemingly high standard in which you would get to travel: It's pitch black construction is h avily decoareted with flower resembling golden patterns, it is spatious and of finest standard in every aspect. There are two comfortable wide seats that face each other in it, one of which you occupy. The carriage walls are covered with quilted dark red silk. The door is locked from the outside.

You notice a scroll container lying at the empty seat in front of you.It's of thick leather, looks newly made and hasn't been opened yet judging by the looks of the unbroken seal.

>open container
The carriage is finally beginning to slow down as you reach for the scroll container. The broken wax falls of it in small pieces on the seat. Seeing this, you hesitate a moment, as if the container wasn't meant for you even though you know it is. It was placed there by trusted messenger, the word directly sent from the court of his Imperial highness. 

You think about it for a second and realise you stopped for a moment not because you would violate the law of secrecy by resting eyes where they didn't belong, but because you know how important the content of the container is.

Your orders are in the container, waiting to be read.

>look at container
It gives an impression of being important due to it having worn the sigill. Rumor has it only the emperor, his nearest of kin and a few selected advisors are authorised to use it. The container is of good craftmanship. It has a cylindrical shape made of just a single piece of leather to better protect its content in case it would be exposed to water. 

In the scroll container is a letter.

* * *

>test scroll
(Testing.)

>[1] l
carriage
The black carriage in which you arrived in is parked at the side, in front of the entrance. The carriage is small, yet of finest comfort.

You notice a scroll container lying at the empty seat in front of you. It's of thick leather, looks unworn and hasn't been opened yet judging from the Imperial seal that is unbroken.

>[2] open scroll container
You open the scroll container, revealing a scroll.

>look at scroll
(the scroll container)
It gives an impression of being important due to it wearing the wax sealing with the Imperial sigill. Rumor has it only the emperor, his nearest of kin and a few selected advisors are authorised to use it.  The container is of good craftmanship, a cylindrical shape made of just a single piece of leather to better protect its content in case it would be exposed to water. 

In the scroll container is a scroll.

* * *

>test msg
(Testing.)

>[1] take scroll container
Taken.

>[2] w
On second thought you don't want to leave the carriage just yet. First you would want to read your orders for the evening events.

>[3] open container
You open the scroll container, revealing a letter.

>[4] examine letter
Orders by the Imperial Five ......I. The gaian representativ

II. Banner spy.

>[5] w
You memorise the content of the letter and make sure to carefully tear it into tiny pieces, discarding them in the evening breez as you open the door of the carriage and step down onto sand. The carriage takes its leave.

yard
You have never witnessed such a marvelous garden before.

>read letter
You see nothing special about the letter.

>examine letter
You see nothing special about the letter.

>take letter
Taken.

>l
carriage
The black carriage in which you arrived in is parked at the side, in front of the entrance. The carriage is small, yet of finest comfort.

You notice a scroll container lying at the empty seat in front of you. It's of thick leather, looks unworn and hasn't been opened yet judging from the Imperial seal that is unbroken.

* * *

>w
You dont want to leave the carriage just yet - there must surely be a good reason for why the scroll container has been placed there, like for instance your orders for the evening events.

* * *

I beg your pardon?

>i
You are carrying:
  a letter

I beg your pardon?

>l
carriage
The black carriage in which you arrived in is parked at the side, in front of the entrance. The carriage is small, yet of finest comfort.

You notice a scroll container lying at the empty seat in front of you. It's of thick leather, looks unworn and the Imperial seal on it has been broken.

>n
You can't go that way.

* * *

>l
carriage
The black carriage in which you arrived in is parked at the side, in front of the entrance. The carriage is small, yet of finest comfort.

You notice a scroll container lying at the empty seat in front of you. It's of thick leather, looks unworn and the Imperial seal on it has been broken.

>e'
That's not a verb I recognise.

>e
You can't go that way.

* * *

>w
You dont want to leave the carriage just yet - there must surely be a good reason for why the scroll container has been placed there, like for instance your orders for the evening events.

>i
You are carrying:
  a thing cailled a letter

* * *

>w
You dont want to leave the carriage just yet - there must surely be a good reason for why the scroll container has been placed there, like for instance your orders for the evening events.

>look
carriage
The black carriage in which you arrived in is parked at the side, in front of the entrance. The carriage is small, yet of finest comfort.

You notice a scroll container lying at the empty seat in front of you. It's of thick leather, looks unworn and the Imperial seal on it has been broken.

>look inside container
The scroll container is empty.

>i
You are carrying:
  a letter

* * *

>i
You are carrying:
  a scroll container (open)
    a letter

* * *

>l
carriage
The black carriage in which you arrived in is parked at the side, in front of the entrance. The carriage is small, yet of finest comfort.

>w
You memorise the content of the letter and make sure to carefully tear it into tiny pieces, discarding them in the evening breez as you open the door of the carriage and step down onto sand. The carriage takes its leave.

* * *

>e
There is nothing to the east - your carriage left after you arrived at the castle premises, and you're to self-loving to dare leave before completing your mission.

>e
carriage
The black carriage in which you arrived in is parked at the side, in front of the entrance. The carriage is small, yet of finest comfort.

You notice a scroll container lying at the empty seat in front of you. It's of thick leather, looks unworn and the Imperial seal on it has been broken.

>l
carriage
The black carriage in which you arrived in is parked at the side, in front of the entrance. The carriage is small, yet of finest comfort.

You notice a scroll container lying at the empty seat in front of you. It's of thick leather, looks unworn and the Imperial seal on it has been broken.

>w
You dont want to leave the carriage just yet - there must surely be a good reason for why the scroll container has been placed there, like for instance your orders for the evening events.

yard
You have never witnessed such a marvelous garden before.

* * *

>look
carriage
The black carriage in which you arrived in is parked at the side, in front of the entrance. The carriage is small, yet of finest comfort.

>w
You memorise the content of the letter and make sure to carefully tear it into tiny pieces, discarding them in the evening breez as you open the door of the carriage and step down onto sand. The carriage takes its leave.

[** Programming error: object#42 (object number 42)  has no property component_parent to set **]

[** Programming error: object#42 (object number 42)  has no property component_sibling to set **]

* * *

>test sg
>--> The following tests are available:
'test msg'

>test msg
(Testing.)

>[1] take scroll container
Taken.

>[2] w
On second thought you don't want to leave the carriage just yet. First you would want to read your orders for the evening events.

>[3] take letter
You can't see any such thing.

>[4] w
On second thought you don't want to leave the carriage just yet. First you would want to read your orders for the evening events.

>[5] examine letter
You can't see any such thing.

>[6] w
On second thought you don't want to leave the carriage just yet. First you would want to read your orders for the evening events.

>l
carriage
The black carriage in which you arrived in is parked at the side, in front of the entrance. The carriage is small, yet of finest comfort.

You notice a scroll container lying at the empty seat in front of you. It's of thick leather, looks unworn and  it's has been broken.

* * *

>test msg
(Testing.)

>[1] take scroll container
Taken.

>[2] w
On second thought you don't want to leave the carriage just yet. First you would want to read your orders for the evening events.

>[3] take letter
You can't see any such thing.

>[4] w
On second thought you don't want to leave the carriage just yet. First you would want to read your orders for the evening events.

>[5] examine letter
You can't see any such thing.

>[6] w
On second thought you don't want to leave the carriage just yet. First you would want to read your orders for the evening events.

>i
You are carrying:
  a letter

* * *

>aas
That's not a verb I recognise.

>l
carriage
The black carriage in which you arrived in is parked at the side, in front of the entrance. The carriage is small, yet of finest comfort.

You notice a scroll container lying at the empty seat in front of you. It's of thick leather, looks unworn and hasn't been opened yet judging from the unbroken Imperial seal. 

The carriage is shaking back and forth as it finds it's way ahead.

>exaine
That's not a verb I recognise.

>examine
(the scroll container)
It gives an impression of being important due to it wearing the wax sealing with the Imperial sigill. Rumor has it only the emperor, his nearest of kin and a few selected advisors are authorised to use it.  The container is of good craftmanship, a cylindrical shape made of just a single piece of leather to better protect its content in case it would be exposed to water.

I beg your pardon?

>l
carriage
The black carriage in which you arrived in is parked at the side, in front of the entrance. The carriage is small, yet of finest comfort.

You notice a scroll container lying at the empty seat in front of you. It's of thick leather, looks unworn and hasn't been opened yet judging from the unbroken Imperial seal.

* * *

>help
 > Introduction to WTLore
   Instructions for Play
   Hints
   Settings
   Contacting the author

>info
That's not a verb I recognise.

* * *

>help
 > Introduction to WTLore
   Instructions for Play
   Hints
   Settings
   Contacting the author

>2
 > Introduction to WTLore
   Instructions for Play

This is a simple demonstration  game.

Please press SPACE to continue.

 > Introduction to WTLore
   Instructions for Play
 > Introduction to WTLore
   Instructions for Play

>1
 > Introduction to WTLore
   Instructions for Play

>1
 > Introduction to WTLore
   Instructions for Play

>2
 > Introduction to WTLore
   Instructions for Play

* * *

 > Introduction to WTLore
   Instructions for Play
 > Introduction to WTLore
   Instructions for Play

This is a simple demonstration  game.

Please press SPACE to continue.

* * *

 > Introduction to WTLore
   Instructions for Play
 > Introduction to WTLore
   Instructions for Play

   Introduction to WTLore
 > Instructions for Play
   Introduction to WTLore
 > Instructions for Play

 > Introduction to WTLore
   Instructions for Play
 > Introduction to WTLore
   Instructions for Play

>n
   Introduction to WTLore
 > Instructions for Play
   Introduction to WTLore
 > Instructions for Play

>p
 > Introduction to WTLore
   Instructions for Play
 > Introduction to WTLore
   Instructions for Play

>n
   Introduction to WTLore
 > Instructions for Play
   Introduction to WTLore
 > Instructions for Play

 > About Interactive Fiction
   What to do with >
   Getting Started
   Rooms and Travel
   Objects
   Controlling the Game
   How the World is Assembled
   If You Get Stuck

   About Interactive Fiction
 > What to do with >
   Getting Started
   Rooms and Travel
   Objects
   Controlling the Game
   How the World is Assembled
   If You Get Stuck
   About Interactive Fiction
 > What to do with >
   Getting Started
   Rooms and Travel
   Objects
   Controlling the Game
   How the World is Assembled
   If You Get Stuck

 > About Interactive Fiction
   What to do with >
   Getting Started
   Rooms and Travel
   Objects
   Controlling the Game
   How the World is Assembled
   If You Get Stuck
 > About Interactive Fiction
   What to do with >
   Getting Started
   Rooms and Travel
   Objects
   Controlling the Game
   How the World is Assembled
   If You Get Stuck

   About Interactive Fiction
 > What to do with >
   Getting Started
   Rooms and Travel
   Objects
   Controlling the Game
   How the World is Assembled
   If You Get Stuck
   About Interactive Fiction
 > What to do with >
   Getting Started
   Rooms and Travel
   Objects
   Controlling the Game
   How the World is Assembled
   If You Get Stuck

   About Interactive Fiction
   What to do with >
 > Getting Started
   Rooms and Travel
   Objects
   Controlling the Game
   How the World is Assembled
   If You Get Stuck
   About Interactive Fiction
   What to do with >
 > Getting Started
   Rooms and Travel
   Objects
   Controlling the Game
   How the World is Assembled
   If You Get Stuck

   About Interactive Fiction
   What to do with >
   Getting Started
 > Rooms and Travel
   Objects
   Controlling the Game
   How the World is Assembled
   If You Get Stuck
   About Interactive Fiction
   What to do with >
   Getting Started
 > Rooms and Travel
   Objects
   Controlling the Game
   How the World is Assembled
   If You Get Stuck

   About Interactive Fiction
   What to do with >
   Getting Started
   Rooms and Travel
 > Objects
   Controlling the Game
   How the World is Assembled
   If You Get Stuck
   About Interactive Fiction
   What to do with >
   Getting Started
   Rooms and Travel
 > Objects
   Controlling the Game
   How the World is Assembled
   If You Get Stuck

   About Interactive Fiction
   What to do with >
   Getting Started
   Rooms and Travel
   Objects
 > Controlling the Game
   How the World is Assembled
   If You Get Stuck
   About Interactive Fiction
   What to do with >
   Getting Started
   Rooms and Travel
   Objects
 > Controlling the Game
   How the World is Assembled
   If You Get Stuck

   About Interactive Fiction
   What to do with >
   Getting Started
   Rooms and Travel
 > Objects
   Controlling the Game
   How the World is Assembled
   If You Get Stuck
   About Interactive Fiction
   What to do with >
   Getting Started
   Rooms and Travel
 > Objects
   Controlling the Game
   How the World is Assembled
   If You Get Stuck

   About Interactive Fiction
   What to do with >
   Getting Started
 > Rooms and Travel
   Objects
   Controlling the Game
   How the World is Assembled
   If You Get Stuck
   About Interactive Fiction
   What to do with >
   Getting Started
 > Rooms and Travel
   Objects
   Controlling the Game
   How the World is Assembled
   If You Get Stuck

   About Interactive Fiction
   What to do with >
 > Getting Started
   Rooms and Travel
   Objects
   Controlling the Game
   How the World is Assembled
   If You Get Stuck
   About Interactive Fiction
   What to do with >
 > Getting Started
   Rooms and Travel
   Objects
   Controlling the Game
   How the World is Assembled
   If You Get Stuck

   About Interactive Fiction
 > What to do with >
   Getting Started
   Rooms and Travel
   Objects
   Controlling the Game
   How the World is Assembled
   If You Get Stuck
   About Interactive Fiction
 > What to do with >
   Getting Started
   Rooms and Travel
   Objects
   Controlling the Game
   How the World is Assembled
   If You Get Stuck

* * *

   About Interactive Fiction
   What to do with >
 > Getting Started
   Rooms and Travel
   Objects
   Controlling the Game
   How the World is Assembled
   If You Get Stuck
   About Interactive Fiction
   What to do with >
 > Getting Started
   Rooms and Travel
   Objects
   Controlling the Game
   How the World is Assembled
   If You Get Stuck

The first thing you want to do when starting a game is acquaint yourself with your surroundings and get a sense of your goal. To this end, you should read the introductory text carefully. Sometimes it contains clues. You will also want to look at the room you are in. Notice where the exits from the room are, and what objects are described here. If any of these seem interesting, you may want to EXAMINE them. 

You might also want to examine yourself (EXAMINE ME) to see whether the author has left you any clues about your character. TAKE INVENTORY will tell you what you're carrying, as well.

Once you've gotten your bearings, you may want to explore. Move from room to room, and check out every location available.

Please press SPACE to continue.

   About Interactive Fiction
   What to do with >
 > Getting Started
   Rooms and Travel
   Objects
   Controlling the Game
   How the World is Assembled
   If You Get Stuck
   About Interactive Fiction
   What to do with >
 > Getting Started
   Rooms and Travel
   Objects
   Controlling the Game
   How the World is Assembled
   If You Get Stuck

* * *

   About Interactive Fiction
 > What to do with >
   Getting Started
   Rooms and Travel
   Objects
   Controlling the Game
   How the World is Assembled
   If You Get Stuck
   About Interactive Fiction
 > What to do with >
   Getting Started
   Rooms and Travel
   Objects
   Controlling the Game
   How the World is Assembled
   If You Get Stuck

The > sign is where the game says, "Okay, what do you want to do now?"  You may respond by typing an instruction -- usually an imperative verb, possibly followed by prepositions and objects.  So, for instance, LOOK, LOOK AT FISH, TAKE FISH.

Please press SPACE to continue.

   About Interactive Fiction
 > What to do with >
   Getting Started
   Rooms and Travel
   Objects
   Controlling the Game
   How the World is Assembled
   If You Get Stuck
   About Interactive Fiction
 > What to do with >
   Getting Started
   Rooms and Travel
   Objects
   Controlling the Game
   How the World is Assembled
   If You Get Stuck

* * *

   About Interactive Fiction
   What to do with >
   Getting Started
 > Rooms and Travel
   Objects
   Controlling the Game
   How the World is Assembled
   If You Get Stuck
   About Interactive Fiction
   What to do with >
   Getting Started
 > Rooms and Travel
   Objects
   Controlling the Game
   How the World is Assembled
   If You Get Stuck

At any given time, you are in a specific location, or room. When you go into a room, the game will print a description of what you can see there. This description will contain two vital kinds of information: things in the room you can interact with or take, and a list of exits, or ways out. If you want to see the description again, you may just type LOOK. 

When you want to leave a location and go to another one, you may communicate this to the game using compass directions: eg, GO NORTH. For simplicity's sake, you are allowed to omit the word GO, and to abbreviate the compass directions. So you may use NORTH, SOUTH, EAST, WEST, NORTHEAST, SOUTHEAST, NORTHWEST, SOUTHWEST, UP, and DOWN, or in short form N, S, E, W, NE, SE, NW, SW, U, and D.

In some locations, IN and OUT will also be useful.

Please press SPACE to continue.

   About Interactive Fiction
   What to do with >
   Getting Started
 > Rooms and Travel
   Objects
   Controlling the Game
   How the World is Assembled
   If You Get Stuck
   About Interactive Fiction
   What to do with >
   Getting Started
 > Rooms and Travel
   Objects
   Controlling the Game
   How the World is Assembled
   If You Get Stuck

* * *

   About Interactive Fiction
   What to do with >
   Getting Started
   Rooms and Travel
 > Objects
   Controlling the Game
   How the World is Assembled
   If You Get Stuck
   About Interactive Fiction
   What to do with >
   Getting Started
   Rooms and Travel
 > Objects
   Controlling the Game
   How the World is Assembled
   If You Get Stuck

Throughout the game there will be assorted objects that you can do things with. Most importantly, you may TAKE or GET items, and (when you are tired of them) DROP them again. INVENTORY (abbreviated I) will list the items you are currently holding. 

There are usually assorted things you may do with these objects. OPEN, CLOSE, WEAR, EAT, LOCK, and UNLOCK are especially common.

Occasionally, you will find that the game does not recognize the name of an object even though it has been described as being in the room with you. If this is the case, the object is just there for scenery, and you may assume that you do not need to interact with it.

Please press SPACE to continue.

   About Interactive Fiction
   What to do with >
   Getting Started
   Rooms and Travel
 > Objects
   Controlling the Game
   How the World is Assembled
   If You Get Stuck
   About Interactive Fiction
   What to do with >
   Getting Started
   Rooms and Travel
 > Objects
   Controlling the Game
   How the World is Assembled
   If You Get Stuck

* * *

   About Interactive Fiction
   What to do with >
   Getting Started
   Rooms and Travel
   Objects
 > Controlling the Game
   How the World is Assembled
   If You Get Stuck
   About Interactive Fiction
   What to do with >
   Getting Started
   Rooms and Travel
   Objects
 > Controlling the Game
   How the World is Assembled
   If You Get Stuck

   About Interactive Fiction
   What to do with >
   Getting Started
   Rooms and Travel
   Objects
   Controlling the Game
 > How the World is Assembled
   If You Get Stuck
   About Interactive Fiction
   What to do with >
   Getting Started
   Rooms and Travel
   Objects
   Controlling the Game
 > How the World is Assembled
   If You Get Stuck

   About Interactive Fiction
   What to do with >
   Getting Started
   Rooms and Travel
   Objects
   Controlling the Game
   How the World is Assembled
 > If You Get Stuck
   About Interactive Fiction
   What to do with >
   Getting Started
   Rooms and Travel
   Objects
   Controlling the Game
   How the World is Assembled
 > If You Get Stuck

 > Explore
   Read carefully
   Be creative
   Cooperate

Examine every object and look at everything in your inventory. Open all the doors you can find, and go through them. Look inside all closed containers. Make sure you've exhausted all the options in your environment. 

Try out all your senses. If the game mentions texture, odor, or sound, try touching, smelling, listening to, or tasting objects.

Be thorough. If you still can't figure out what to do, try opening windows, looking under beds, etc. Sometimes objects are well-hidden.

Please press SPACE to continue.

 > Explore
   Read carefully
   Be creative
   Cooperate
 > Explore
   Read carefully
   Be creative
   Cooperate

Examine every object and look at everything in your inventory. Open all the doors you can find, and go through them. Look inside all closed containers. Make sure you've exhausted all the options in your environment. 

Try out all your senses. If the game mentions texture, odor, or sound, try touching, smelling, listening to, or tasting objects.

Be thorough. If you still can't figure out what to do, try opening windows, looking under beds, etc. Sometimes objects are well-hidden.

Please press SPACE to continue.

* * *

 > Explore
   Read carefully
   Be creative
   Cooperate
 > Explore
   Read carefully
   Be creative
   Cooperate

>q
   About Interactive Fiction
   What to do with >
   Getting Started
   Rooms and Travel
   Objects
   Controlling the Game
   How the World is Assembled
 > If You Get Stuck

>q
   Introduction to WTLore
 > Instructions for Play

>q
carriage
The black carriage in which you arrived in is parked at the side, in front of the entrance. The carriage is small, yet of finest comfort.

You notice a scroll container lying at the empty seat in front of you. It's of thick leather, looks unworn and hasn't been opened yet judging from the unbroken Imperial seal.

>info
 > Introduction to WTLore
   Instructions for Play

>q
carriage
The black carriage in which you arrived in is parked at the side, in front of the entrance. The carriage is small, yet of finest comfort.

You notice a scroll container lying at the empty seat in front of you. It's of thick leather, looks unworn and hasn't been opened yet judging from the unbroken Imperial seal.

* * *

   Introduction to WTLore
   Instructions for Play
   Hints
 > Settings
   Contacting the author
   Introduction to WTLore
   Instructions for Play
   Hints
 > Settings
   Contacting the author

   Introduction to WTLore
   Instructions for Play
   Hints
   Settings
 > Contacting the author
   Introduction to WTLore
   Instructions for Play
   Hints
   Settings
 > Contacting the author

   Introduction to WTLore
   Instructions for Play
   Hints
   Settings
 > Contacting the author
   Introduction to WTLore
   Instructions for Play
   Hints
   Settings
 > Contacting the author

   Introduction to WTLore
   Instructions for Play
   Hints
 > Settings
   Contacting the author
   Introduction to WTLore
   Instructions for Play
   Hints
 > Settings
   Contacting the author

carriage
 The night black carriage is heavily decoareted with flower resembling golden patterns, it is spatious and of finest standard in every aspect. There are two comfortable benches that face each other in it, one of which you occupy. The carriage walls are covered with quilted dark red silk, isolated with an unknown material. 

You notice a scroll container lying at the empty seat in front of you.  It's of thick leather, looks newly made and hasn't been opened yet judging by the looks of the unbroken Imperial seal.

This modest piece of interactive fiction is played out in the setting of WTactics.org and has been written to give you a richer understanding and experience of the universe in which WT is set. The game can stand on its own without any prior knowledge about WTactics.org or CCG:s.

Please press SPACE to continue.

 > Introduction to WTLore
   Instructions for Play
   Contacting the author
 > Introduction to WTLore
   Instructions for Play
   Contacting the author

   Introduction to WTLore
 > Instructions for Play
   Contacting the author
   Introduction to WTLore
 > Instructions for Play
   Contacting the author

 > Introduction to WTLore
   Instructions for Play
   Contacting the author
 > Introduction to WTLore
   Instructions for Play
   Contacting the author

* * *

   Introduction to WTLore
 > Instructions for Play
   Contacting the author
   Introduction to WTLore
 > Instructions for Play
   Contacting the author

 > About Interactive Fiction
   What to do with >
   Getting Started
   Rooms and Travel
   Objects
   Controlling the Game
   How the World is Assembled
   If You Get Stuck

   Introduction to WTLore
 > Instructions for Play
   Contacting the author

carriage
The black carriage in which you arrived in is parked at the side, in front of the entrance. The carriage is small, yet of finest comfort.

You notice a scroll container lying at the empty seat in front of you. It's of thick leather, looks unworn and hasn't been opened yet judging from the unbroken Imperial seal.

* * *

carriage
 The night black carriage is heavily decoareted with flower resembling golden patterns, it is spatious and of finest standard in every aspect. There are two comfortable benches that face each other in it, one of which you occupy. The carriage walls are covered with quilted dark red silk, isolated with an unknown material. 

You notice a scroll container lying at the empty seat in front of you.  It's of thick leather, looks newly made and hasn't been opened yet judging by the looks of the unbroken Imperial seal.

>h
1/2: Remember that you know how to macrame.

2/2: Oh, come now, isn't it obvious?

Press SPACE to return to the menu.

* * *

>q
   Introduction to WTLore
   Instructions for Play
 > Hints
   Settings
   Contacting the author

   Introduction to WTLore
   Instructions for Play
   Hints
 > Settings
   Contacting the author
   Introduction to WTLore
   Instructions for Play
   Hints
 > Settings
   Contacting the author

 > Verbose room descriptions
   Score notification on

   Verbose room descriptions
 > Score notification on
   Verbose room descriptions
 > Score notification on

Score notification off.

   Verbose room descriptions
 > Score notification off
   Verbose room descriptions
 > Score notification off

Score notification on.

   Verbose room descriptions
 > Score notification on
   Verbose room descriptions
 > Score notification on

 > Verbose room descriptions
   Score notification on
 > Verbose room descriptions
   Score notification on

WTLore is now in its "brief" printing mode, which gives long descriptions of places never before visited and short descriptions otherwise.

 > Brief room descriptions
   Score notification on
 > Brief room descriptions
   Score notification on

WTLore is now in its "superbrief" mode, which always gives short descriptions of locations (even if you haven't been there before).

 > Superbrief room descriptions
   Score notification on
 > Superbrief room descriptions
   Score notification on

WTLore is now in its "verbose" mode, which always gives long descriptions of locations (even if you've been there before).

 > Verbose room descriptions
   Score notification on
 > Verbose room descriptions
   Score notification on

   Verbose room descriptions
 > Score notification on
   Verbose room descriptions
 > Score notification on

>q
   Introduction to WTLore
   Instructions for Play
   Hints
 > Settings
   Contacting the author

   Introduction to WTLore
   Instructions for Play
 > Hints
   Settings
   Contacting the author
   Introduction to WTLore
   Instructions for Play
 > Hints
   Settings
   Contacting the author

   Introduction to WTLore
 > Instructions for Play
   Hints
   Settings
   Contacting the author
   Introduction to WTLore
 > Instructions for Play
   Hints
   Settings
   Contacting the author

 > Introduction to WTLore
   Instructions for Play
   Hints
   Settings
   Contacting the author
 > Introduction to WTLore
   Instructions for Play
   Hints
   Settings
   Contacting the author

This modest piece of interactive fiction is played out in the setting of WTactics.org and has been written to give you a richer understanding and experience of the universe in which WT is set. The game can stand on its own without any prior knowledge about WTactics.org or CCG:s.

Please press SPACE to continue.

 > Introduction to WTLore
   Instructions for Play
   Hints
   Settings
   Contacting the author
 > Introduction to WTLore
   Instructions for Play
   Hints
   Settings
   Contacting the author

>q
carriage
The black carriage in which you arrived in is parked at the side, in front of the entrance. The carriage is small, yet of finest comfort.

You notice a scroll container lying at the empty seat in front of you. It's of thick leather, looks unworn and hasn't been opened yet judging from the unbroken Imperial seal.

* * *

>help
 > Introduction to WTLore
   Instructions for Play
   Hints
   Settings
   Contacting the author

>q
carriage
 It's pitch black construction is heavily decoareted with flower resembling golden patterns, it is spatious and of finest standard in every aspect. There are two comfortable wide seats that face each other in it, one of which you occupy. The carriage walls are covered with quilted dark red silk. The door is locked from the outside.

You notice a scroll container lying at the empty seat in front of you.  It's of thick leather, looks newly made and hasn't been opened yet judging by the looks of the unbroken Imperial seal.

I beg your pardon?

>look
carriage
 It's pitch black construction is heavily decoareted with flower resembling golden patterns, it is spatious and of finest standard in every aspect. There are two comfortable wide seats that face each other in it, one of which you occupy. The carriage walls are covered with quilted dark red silk. The door is locked from the outside.

You notice a scroll container lying at the empty seat in front of you.  It's of thick leather, looks newly made and hasn't been opened yet judging by the looks of the unbroken Imperial seal. 

You're bored by the long travels and have a tense feeling.

>restart
Are you sure you want to restart?

>y
WTLore
A part of an interactive Background Story by snowdrop
Release 0 / Serial number 110501 / Inform 7 build 6G60 (I6/v6.32 lib 6/12N) SD

carriage
When boarding the carriage you were impressed by the seemingly high standard in which you would get to travel: It's pitch black construction is heavily decoareted with flower resembling golden patterns, it is spatious and of finest standard in every aspect. There are two comfortable wide seats that face each other in it, one of which you occupy. The carriage walls are covered with quilted dark red silk. The door is locked from the outside.

You notice a scroll container lying at the empty seat in front of you.  It's of thick leather, looks newly made and hasn't been opened yet judging by the looks of the unbroken Imperial seal.

>examine tube
It gives an impression of being important due to it wearing the wax sealing with the Imperial sigill. Rumor has it only the emperor, his nearest of kin and a few selected advisors are authorised to use it. The container is of good craftmanship. It has a cylindrical shape made of just a single piece of leather to better protect its content in case it would be exposed to water.

>open tube
The carriage is finally beginning to slow down.

>look
carriage
 It's pitch black construction is heavily decoareted with flower resembling golden patterns, it is spatious and of finest standard in every aspect. There are two comfortable wide seats that face each other in it, one of which you occupy. The carriage walls are covered with quilted dark red silk. The door is locked from the outside.

The scroll container is still here. It's of thick leather, looks newly made and is open. The Imperial seal on it is broken.

* * *

WTLore
An Interactive Fiction by snowdrop
Release 1 / Serial number 110423 / Inform 7 build 6G60 (I6/v6.32 lib 6/12N) SD

carriage
The black carriage in which you arrived in is parked at the side, in front of the entrance. The carriage is small, yet of finest comfort.

You notice a scroll container lying at the empty seat in front of you. It's of thick leather, looks unworn and hasn't been opened yet judging from the unbroken Imperial seal.

>look
carriage
The black carriage in which you arrived in is parked at the side, in front of the entrance. The carriage is small, yet of finest comfort.

You notice a scroll container lying at the empty seat in front of you. It's of thick leather, looks unworn and hasn't been opened yet judging from the unbroken Imperial seal. 

The carriage is shaking back and forth as it finds it's way ahead.

>w
You decide it's time to fulfil your duties & finally gather courage to leave the carriage
yard
You have never witnessed such a marvelous garden before.

The carriage is shaking back and forth as it finds it's way ahead.

>e
carriage
The black carriage in which you arrived in is parked at the side, in front of the entrance. The carriage is small, yet of finest comfort.

You notice a scroll container lying at the empty seat in front of you. It's of thick leather, looks unworn and hasn't been opened yet judging from the unbroken Imperial seal. 

The carriage is shaking back and forth as it finds it's way ahead.

* * *

WTLore
An Interactive Fiction by snowdrop
Release 1 / Serial number 110423 / Inform 7 build 6G60 (I6/v6.32 lib 6/12N) SD

carriage
The black carriage in which you arrived in is parked at the side, in front of the entrance. The carriage is small, yet of finest comfort.

You notice a scroll container lying at the empty seat in front of you. It's of thick leather, looks unworn and hasn't been opened yet judging from the unbroken Imperial seal.

>w
You decide it's time to fulfil your duties & finally gather courage to leave the carriage
You dont want to leave the carriage just yet - there must surely be a good reason for why the scroll container has been placed there.

>l
carriage
The black carriage in which you arrived in is parked at the side, in front of the entrance. The carriage is small, yet of finest comfort.

You notice a scroll container lying at the empty seat in front of you. It's of thick leather, looks unworn and hasn't been opened yet judging from the unbroken Imperial seal.

* * *

WTLore
An Interactive Fiction by snowdrop
Release 1 / Serial number 110423 / Inform 7 build 6G60 (I6/v6.32 lib 6/12N) SD

carriage
The black carriage in which you arrived in is parked at the side, in front of the entrance. The carriage is small, yet of finest comfort.

You notice a scroll container lying at the empty seat in front of you. It's of thick leather, looks unworn and hasn't been opened yet judging from the unbroken Imperial seal.

>open container
You open the scroll container, revealing a letter.

* * *

>take letter
Taken.

>w
You decide it's time to fulfil your duties & finally gather courage to leave the carriage

>l
carriage
The black carriage in which you arrived in is parked at the side, in front of the entrance. The carriage is small, yet of finest comfort.

You notice a scroll container lying at the empty seat in front of you. It's of thick leather, looks unworn and the Imperial seal on it has been broken.

>i
You are carrying:
  a letter

>w
You decide it's time to fulfil your duties & finally gather courage to leave the carriage

* * *

>l
carriage
The black carriage in which you arrived in is parked at the side, in front of the entrance. The carriage is small, yet of finest comfort.

You notice a scroll container lying at the empty seat in front of you. It's of thick leather, looks unworn and the Imperial seal on it has been broken.

>look at letter
You see nothing special about the letter.

>examine letter
You see nothing special about the letter.

>w
You decide it's time to fulfil your duties & finally gather courage to leave the carriage

* * *

WTLore
An Interactive Fiction by snowdrop
Release 1 / Serial number 110423 / Inform 7 build 6G60 (I6/v6.32 lib 6/12N) SD

carriage
The black carriage in which you arrived in is parked at the side, in front of the entrance. The carriage is small, yet of finest comfort.

You notice a scroll container lying at the empty seat in front of you. It's of thick leather, looks unworn and hasn't been opened yet judging from the unbroken Imperial seal.

* * *

>msg get
That's not a verb I recognise.

>test msg
(Testing.)

>[1] l
carriage
The black carriage in which you arrived in is parked at the side, in front of the entrance. The carriage is small, yet of finest comfort.

You notice a scroll container lying at the empty seat in front of you. It's of thick leather, looks unworn and hasn't been opened yet judging from the unbroken Imperial seal. 

>[2] open scroll container
You open the scroll container, revealing a letter.

>[3] w
You dont want to leave the carriage just yet - there must surely be a good reason for why the scroll container has been placed there, like for instance your orders for the evening events.

>[4] take letter
Taken.

>[5] w
You dont want to leave the carriage just yet - there must surely be a good reason for why the scroll container has been placed there, like for instance your orders for the evening events.

>[6] examine letter
Orders by the Imperial Five ......I. The gaian representativ

II. Banner spy.

>[7] w
You dont want to leave the carriage just yet - there must surely be a good reason for why the scroll container has been placed there, like for instance your orders for the evening events.

* * *

>w
On second thought you don't want to leave the carriage just yet. First you would want to read your orders for the evening events.

>look
carriage
The black carriage in which you arrived in is parked at the side, in front of the entrance. The carriage is small, yet of finest comfort.

You notice a scroll container lying at the empty seat in front of you. It's of thick leather, looks unworn and hasn't been opened yet judging from the unbroken Imperial seal.

>take container
Taken.

>w
You dont want to leave the carriage just yet - there must surely be a good reason for why the scroll container has been placed there, like for instance your orders for the evening events

>open container
You open the scroll container, revealing a letter.

>w
You dont want to leave the carriage just yet - there must surely be a good reason for why the scroll container has been placed there, like for instance your orders for the evening events

>take letter
Taken.

>w
yard
You have never witnessed such a marvelous garden before.

>e
carriage
The black carriage in which you arrived in is parked at the side, in front of the entrance. The carriage is small, yet of finest comfort.

>w
yard
You have never witnessed such a marvelous garden before.

* * *

>w
On second thought you don't want to leave the carriage just yet. First you would want to read your orders for the evening events.

>w
Castle Hallway room
You find yourself standing in the castle entrance. It has a very high ceiling with what seems to be sections of thick heavy glass, revealing a clear night with stars incognito. There is a dim light at the east end of the passage.

There is a small wicker cage discarded nearby.

>w
You can't go that way.

>e
yard
You have never witnessed such a marvelous garden before.

>e
There is nothing to the east - your carriage left after you arrived at the castle premises, and you're to self-loving to dare leave before completing your mission.

* * *

>w
On second thought you don't want to leave the carriage just yet. First you would want to read your orders for the evening events.

>e
There is nothing to the east - your carriage left after you arrived at the castle premises, and you're to self-loving to dare leave before completing your mission.

>i
You are carrying nothing.

* * *

>w
On second thought you don't want to leave the carriage just yet. First you would want to read your orders for the evening events.

>l
carriage
The black carriage in which you arrived in is parked at the side, in front of the entrance. The carriage is small, yet of finest comfort.

You notice a scroll container lying at the empty seat in front of you. It's of thick leather, looks unworn and hasn't been opened yet judging from the unbroken Imperial seal. 

The carriage wheels rumble over a small hole in the ground.

>w
On second thought you don't want to leave the carriage just yet. First you would want to read your orders for the evening events.

>w
On second thought you don't want to leave the carriage just yet. First you would want to read your orders for the evening events.

You feel how the carriage is turning in a steep curve, aking you lean into that direction.

>l
carriage
The black carriage in which you arrived in is parked at the side, in front of the entrance. The carriage is small, yet of finest comfort.

You notice a scroll container lying at the empty seat in front of you. It's of thick leather, looks unworn and hasn't been opened yet judging from the unbroken Imperial seal.

>examine letter
You can't see any such thing.

>examine container
It gives an impression of being important due to it wearing the wax sealing with the Imperial sigill. Rumor has it only the emperor, his nearest of kin and a few selected advisors are authorised to use it.  The container is of good craftmanship, a cylindrical shape made of just a single piece of leather to better protect its content in case it would be exposed to water.

>open container
You open the scroll container, revealing a letter.

>w
On second thought you don't want to leave the carriage just yet. First you would want to read your orders for the evening events.

You are getting closer by the minute and will soon get to prove yourself.

>take letter
Taken.

The carriage wheels rumble over a small hole in the ground.

>w
On second thought you don't want to leave the carriage just yet. First you would want to read your orders for the evening events.

>put letter in container
You put the letter into the scroll container.

>look container
It gives an impression of being important due to it wearing the wax sealing with the Imperial sigill. Rumor has it only the emperor, his nearest of kin and a few selected advisors are authorised to use it. 

In the scroll container is a letter.

>look at letter
Orders by the Imperial Five ......I. The gaian representativ

II. Banner spy.

>w
You memorise the content of the letter and make sure to carefully tear it into tiny pieces, discarding them in the evening breez as you open the door of the carriage and step down onto sand. The carriage takes its leave.

yard
You have never witnessed such a marvelous garden before.

>e
There is nothing to the east - your carriage left after you arrived at the castle premises, and you're to self-loving to dare leave before completing your mission.

* * *

>leave
But you aren't in anything at the moment.

>look
carriage
The black carriage in which you arrived in is parked at the side, in front of the entrance. The carriage is small, yet of finest comfort.

You notice a scroll container lying at the empty seat in front of you. It's of thick leather, looks unworn and hasn't been opened yet judging from the unbroken Imperial seal.

>i
You are carrying nothing.

>look
carriage
The black carriage in which you arrived in is parked at the side, in front of the entrance. The carriage is small, yet of finest comfort.

You notice a scroll container lying at the empty seat in front of you. It's of thick leather, looks unworn and hasn't been opened yet judging from the unbroken Imperial seal. 

The carriage wheels rumble over a small hole in the ground.

>look
carriage
The black carriage in which you arrived in is parked at the side, in front of the entrance. The carriage is small, yet of finest comfort.

You notice a scroll container lying at the empty seat in front of you. It's of thick leather, looks unworn and hasn't been opened yet judging from the unbroken Imperial seal.

>look
carriage
The black carriage in which you arrived in is parked at the side, in front of the entrance. The carriage is small, yet of finest comfort.

You notice a scroll container lying at the empty seat in front of you. It's of thick leather, looks unworn and hasn't been opened yet judging from the unbroken Imperial seal. 

You feel how the carriage is turning in a steep curve, aking you lean into that direction.

>look
carriage
The black carriage in which you arrived in is parked at the side, in front of the entrance. The carriage is small, yet of finest comfort.

You notice a scroll container lying at the empty seat in front of you. It's of thick leather, looks unworn and hasn't been opened yet judging from the unbroken Imperial seal. 

You are getting closer by the minute and will soon get to prove yourself.

* * *

>exit
But you aren't in anything at the moment.

* * *

>test me
>--> The following tests are available:
'test msg'

>test msg
(Testing.)

>[1] take scroll container
Taken.

>[2] w
On second thought you don't want to leave the carriage just yet. First you would want to read your orders for the evening events.

yard
You have never witnessed such a marvelous garden before.

>[3] open container
You open the scroll container, revealing a letter.

>[4] examine letter
Orders by the Imperial Five ......I. The gaian representativ

II. Banner spy.

>[5] w

Castle Hallway room
You find yourself standing in the castle entrance. It has a very high ceiling with what seems to be sections of thick heavy glass, revealing a clear night with stars incognito. There is a dim light at the east end of the passage.

There is a small wicker cage discarded nearby.

>l
Castle Hallway room
You find yourself standing in the castle entrance. It has a very high ceiling with what seems to be sections of thick heavy glass, revealing a clear night with stars incognito. 

There is a small wicker cage discarded nearby.

>e
yard
You have never witnessed such a marvelous garden before.

* * *

>e
There is nothing to the east - your carriage left after you arrived at the castle premises, and you're to self-loving to dare leave before completing your mission.

>end
That's not a verb I recognise.

>quit
Are you sure you want to quit?

>y
[ The game has finished ]

* * *

>i
You are carrying nothing.

The carriage wheels rumble over a small hole in the ground.

>i
You are carrying nothing.

>i
You are carrying nothing.

>i
You are carrying nothing.

You feel how the carriage is turning in a steep curve, aking you lean into that direction.

>i
You are carrying nothing.

>i
You are carrying nothing.

You are getting closer by the minute and will soon get to prove yourself.

* * *

>version
WTLore
A part of an interactive Background Story by "snowdrop" The story genre is "Fantasy"
Release 0 / Serial number 110423 / Inform 7 build 6G60 (I6/v6.32 lib 6/12N) SD
Identification number: //BAE09626-6957-11E0-8FB3-5855CAF94B07//
Standard interpreter 1.1 (1F) / Library serial number 080126
Standard Rules version 2/090402 by Graham Nelson

* * *

>e
You can't go that way.

You're both tense and bored.

>e
You can't go that way.

Will this journey never end?

>e
You can't go that way.

The carriage wheels rumble over a small hole in the ground.

>e
You can't go that way.

>e
You can't go that way.

>e
You can't go that way.

You feel how the carriage is turning in a steep curve, making you lean into that direction.

* * *

>take container
Taken.

>i
You are carrying:
  a scroll container (closed)

>open container
You open the scroll container, revealing a letter.

>e
You can't go that way.

>examine letter
Orders by the Imperial Five ......I. The gaian representativ

II. Banner spy.

>e
You can't go that way.

>w
You memorise the content of the letter and make sure to carefully tear it into tiny pieces, discarding them in the evening breez as you open the door of the carriage and step down onto sand. The carriage takes its leave.

Yard
You have never witnessed such a marvelous garden before.

>w
Castle Hallway room
You find yourself standing in the castle entrance. It has a very high ceiling with what seems to be sections of thick heavy glass, revealing a clear night with stars incognito. There is a dim light at the east end of the passage.

There is a small wicker cage discarded nearby.

* * *

>actions on
Actions listing on.

>look
[looking]
carriage
When boarding the carriage eariler today you were impressed by the high standard in which you would get to travel: The black glossy carriage is heavily decoareted with flower resembling golden patterns, it is spatious and of finest standard in every aspect. There are two comfortable benches that face each other in it, one of which you occupy. The carriage walls are covered with quilted dark red silk, isolated with an unknown material. 

 You notice a scroll container lying at the empty seat in front of you.  It's of thick leather, looks unworn and hasn't been opened yet judging from the unbroken Imperial seal. 

[looking - succeeded]

>e
[going east]
You can't go that way.
[going east - failed the can't go that way rule]

>e
[going east]
You can't go that way.
[going east - failed the can't go that way rule]

>n
[going north]
You can't go that way.
[going north - failed the can't go that way rule]

>w
[going west]
On second thought you don't want to leave the carriage just yet. First you would want to read your orders for the evening events.
[going west - failed]

* * *

>actions on
Actions listing on.

>l
[looking]
carriage
When boarding the carriage eariler today you were impressed by the high standard in which you would get to travel: The black glossy carriage is heavily decoareted with flower resembling golden patterns, it is spatious and of finest standard in every aspect. There are two comfortable benches that face each other in it, one of which you occupy. The carriage walls are covered with quilted dark red silk, isolated with an unknown material. 

 You notice a scroll container lying at the empty seat in front of you.  It's of thick leather, looks unworn and hasn't been opened yet judging from the unbroken Imperial seal. 

[looking - succeeded]

>actions off
Actions listing off.

>w
On second thought you don't want to leave the carriage just yet. First you would want to read your orders for the evening events.  You suspect they are in the mystical container  that's here at the seat in front of you, waiting for curious eyes to wander upon it's inner secrets.

>actions on
Actions listing on.

>q
[quitting the game]
Are you sure you want to quit?

>n
[quitting the game - succeeded]

>l
[looking]
carriage
When boarding the carriage eariler today you were impressed by the high standard in which you would get to travel: The black glossy carriage is heavily decoareted with flower resembling golden patterns, it is spatious and of finest standard in every aspect. There are two comfortable benches that face each other in it, one of which you occupy. The carriage walls are covered with quilted dark red silk, isolated with an unknown material. 

 You notice a scroll container lying at the empty seat in front of you.  It's of thick leather, looks unworn and hasn't been opened yet judging from the unbroken Imperial seal. 

[looking - succeeded]

>w
[going west]
On second thought you don't want to leave the carriage just yet. First you would want to read your orders for the evening events.  You suspect they are in the mystical container  that's here at the seat in front of you, waiting for curious eyes to wander upon it's inner secrets.
[going west - failed]

* * *

>actions on
Actions listing on.

>z
[waiting]
Time passes.
[waiting - succeeded]

>z
[waiting]
Time passes.
[waiting - succeeded]

>z
[waiting]
Time passes.
[waiting - succeeded]

You're bored by the long travels and have a tense feeling.

I beg your pardon?

>z
[waiting]
Time passes.
[waiting - succeeded]

>z
[waiting]
Time passes.
[waiting - succeeded]

Will this journey never end? Time goes slowly by.

>z
[waiting]
Time passes.
[waiting - succeeded]

>z
[waiting]
Time passes.
[waiting - succeeded]

The carriage wheels rumble over a small hole in the ground.

>l
[looking]
carriage
 It's night black construction is heavily decoareted with flower resembling golden patterns, it is spatious and of finest standard in every aspect. There are two comfortable benches that face each other in it, one of which you occupy. The carriage walls are covered with quilted dark red silk, isolated with an unknown material. 

You notice a scroll container lying at the empty seat in front of you.  It's of thick leather, looks newly made and hasn't been opened yet judging by the looks of the unbroken Imperial seal. 

[looking - succeeded]

I beg your pardon?

>open container
[opening the scroll container]
You open the scroll container, revealing a letter.
[opening the scroll container - succeeded]

You feel how the carriage is turning in a steep curve, making you lean into that direction.

>take letter
[taking the letter]
Taken.
[taking the letter - succeeded]

The sound from the fast turning carriage wheels makes it hard to focus.

I beg your pardon?

>i
[taking inventory]
You are carrying:
  a letter

[taking inventory - succeeded]

>look at letter
[examining the letter]
Letter text here...

[examining the letter - succeeded]

The carriage is finally slowing down, and halts suddenly. You have arrived.

It's time to perform the role of your life. You couldn't believe it when it happened: The huge honour, to be chosen for the task at hand. This would surely be the single most important assignment you could have dreamt of ever getting.
You memorise the content of the letter and make sure to carefully tear it into tiny random pieces beyond recognition. As you open the door you discard them in the evening breez while stepping down onto the sand. The carriage takes its leave.

[looking]
Yard
You have never witnessed such a marvelous garden before.

[looking - succeeded]

>i
[taking inventory]
You are carrying nothing.

[taking inventory - succeeded]

>plll
That's not a verb I recognise.

>w
[going west]

Castle Hallway room
You find yourself standing in the castle entrance. It has a very high ceiling with what seems to be sections of thick heavy glass, revealing a clear night with stars incognito. There is a dim light at the east end of the passage.

There is a small wicker cage discarded nearby.

[going west - succeeded]

* * *

>i
You are carrying:
  a scroll container (closed)

>examine container
It gives an impression of being important due to it wearing the wax sealing with the Imperial sigill. Rumor has it only the emperor, his nearest of kin and a few selected advisors are authorised to use it.  The container is of good craftmanship, a cylindrical shape made of just a single piece of leather to better protect its content in case it would be exposed to water. 

Will this journey never end?

>open container
You open the scroll container, revealing a letter.

The carriage wheels rumble over a small hole in the ground.

>w
On second thought you don't want to leave the carriage just yet. First you would want to read your orders for the evening events.

* * *

>look
Yard
Three fountains in a row.

* * *

>zzz
That's not a verb I recognise.

>z
Time passes.

>z
Time passes.

You're bored by the long travels and have a tense feeling.

>z
Time passes.

* * *

>z
Time passes.

Will this journey never end? Time goes slowly by.

>z
Time passes.

I beg your pardon?

I beg your pardon?

* * *

>z
Time passes.

The carriage wheels rumble over a small hole in the ground.

>l
carriage
 The black glossy carriage is heavily decoareted with flower resembling golden patterns, it is spatious and of finest standard in every aspect. There are two comfortable benches that face each other in it, one of which you occupy. The carriage walls are covered with quilted dark red silk, isolated with an unknown material. 

 You notice a scroll container lying at the empty seat in front of you.  It's of thick leather, looks unworn and hasn't been opened yet judging from the unbroken Imperial seal.

>z
Time passes.

>l
carriage
 The black glossy carriage is heavily decoareted with flower resembling golden patterns, it is spatious and of finest standard in every aspect. There are two comfortable benches that face each other in it, one of which you occupy. The carriage walls are covered with quilted dark red silk, isolated with an unknown material. 

 You notice a scroll container lying at the empty seat in front of you.  It's of thick leather, looks unworn and hasn't been opened yet judging from the unbroken Imperial seal. 

You feel how the carriage is turning in a steep curve, making you lean into that direction.

* * *

>l tube
It gives an impression of being important due to it wearing the wax sealing with the Imperial sigill. Rumor has it only the emperor, his nearest of kin and a few selected advisors are authorised to use it. The container is of good craftmanship. It has a cylindrical shape made of just a single piece of leather to better protect its content in case it would be exposed to water.

>l
carriage
 It's night black construction is heavily decoareted with flower resembling golden patterns, it is spatious and of finest standard in every aspect. There are two comfortable benches that face each other in it, one of which you occupy. The carriage walls are covered with quilted dark red silk, isolated with an unknown material. 

The scroll container is still here. It's of thick leather, looks newly made and hasn't been opened yet judging by the looks of the unbroken Imperial seal. 

You're bored by the long travels and have a tense feeling.

>l cylinder
It gives an impression of being important due to it wearing the wax sealing with the Imperial sigill. Rumor has it only the emperor, his nearest of kin and a few selected advisors are authorised to use it.

Will this journey never end? Time goes slowly by.

>take paper
You can't see any such thing.

>open cylinder
You open the scroll container, revealing a letter.

>look
carriage
 It's night black construction is heavily decoareted with flower resembling golden patterns, it is spatious and of finest standard in every aspect. There are two comfortable benches that face each other in it, one of which you occupy. The carriage walls are covered with quilted dark red silk, isolated with an unknown material. 

The scroll container is still here. It's of thick leather, looks newly made and the Imperial seal on it has been broken.

The carriage wheels rumble over a small hole in the ground.

* * *

>take paper
You can't see any such thing.

>open tube
You open the scroll container, revealing a letter.

>look at tube
It gives an impression of being important due to it wearing the wax sealing with the Imperial sigill. Rumor has it only the emperor, his nearest of kin and a few selected advisors are authorised to use it. The container is of good craftmanship. It has a cylindrical shape made of just a single piece of leather to better protect its content in case it would be exposed to water. 

In the scroll container is a letter.

>look at letter
Letter text here...

>read paper
Letter text here...

>read note
Letter text here...

The carriage is finally slowing down, and halts suddenly. You have arrived.

It's time to perform the role of your life. You couldn't believe it when it happened: The huge honour, to be chosen for the task at hand. This would surely be the single most important assignment you could have dreamt of ever getting.
You memorise the content of the letter and make sure to carefully tear it into tiny random pieces. As  discarding them in the evening breez as you open the door of the carriage and step down onto sand. The carriage takes its leave.

Yard
You have never witnessed such a marvelous garden before.

* * *

>open tube
The carriage is finally beginning to slow down as you reach for the scroll container. The broken wax falls of it in small pieces on the seat. Seeing this, you hesitate a moment, as if the container wasn't meant for you even though you know it is. It was placed there by trusted messenger, the word directly sent from the court of his Imperial highness. 

You think about it for a second and realise you stopped for a moment not because you would violate the law of secrecy by resting eyes where they didn't belong, but because you know how important the content of the container is.

Your orders are in the container, waiting to be read.

>look message
Letter text here...

* * *

>l
carriage
It's pitch black construction is heavily decoareted with flower resembling golden patterns, it is spatious and of finest standard in every aspect. There are two comfortable wide seats that face each other in it, one of which you occupy. The carriage walls are covered with quilted dark red silk. The door is locked from the outside.

On the seat there's a red piece of wax. It used to guarantee the authenticity of the msg, but is just smudgy filth now.

The scroll container is still here. It's of thick leather, looks newly made and is open. The Imperial seal on it is broken.

* * *

>take wax
Taken.

>i
You are carrying:
  a sigill wax

* * *

>l
carriage
It's pitch black construction is heavily decoareted with flower resembling golden patterns, it is spatious and of finest standard in every aspect. There are two comfortable wide seats that face each other in it, one of which you occupy. The carriage walls are covered with quilted dark red silk. The door is locked from the outside.

On the seat there's a red piece of wax. It used to guarantee the authenticity of the msg, but is just smudgy filth now.

The scroll container is still here. It's of thick leather, looks newly made and is open. The Imperial seal on it is broken.

I beg your pardon?

* * *

>l
carriage
It's pitch black construction is heavily decoareted with flower resembling golden patterns, it is spatious and of finest standard in every aspect. There are two comfortable wide seats that face each other in it, one of which you occupy. The carriage walls are covered with quilted dark red silk. The door is locked from the outside.

On the seat there's a red piece of wax. It used to guarantee the authenticity of the msg, but is just smudgy filth now.

The scroll container is still here. It's of thick leather, looks newly made and is open. The Imperial seal on it is broken.

>take some wax
Taken.

>i
You are carrying:
  some pieces of wax

>drop wax
Dropped.

>take pieces
Taken.

>i
You are carrying:
  some pieces of wax

>drop sigill
You can't see any such thing.

>drop emblem
You can't see any such thing.

>drop piece
You can't see any such thing.

>i'
That's not a verb I recognise.

I beg your pardon?

>i
You are carrying:
  some pieces of wax

* * *

>drop wax
Dropped.

>take sigill
You can't see any such thing.

* * *

I beg your pardon?

>l
carriage
It's pitch black construction is heavily decoareted with flower resembling golden patterns, it is spatious and of finest standard in every aspect. There are two comfortable wide seats that face each other in it, one of which you occupy. The carriage walls are covered with quilted dark red silk. The door is locked from the outside.

On the seat there's a red piece of wax. It used to guarantee the authenticity of the msg, but is just smudgy filth now.

The scroll container is still here. It's of thick leather, looks newly made and is open. The Imperial seal on it is broken.

>t sigill
That's not a verb I recognise.

>take sigill
You can't see any such thing.

>look
carriage
It's pitch black construction is heavily decoareted with flower resembling golden patterns, it is spatious and of finest standard in every aspect. There are two comfortable wide seats that face each other in it, one of which you occupy. The carriage walls are covered with quilted dark red silk. The door is locked from the outside.

On the seat there's a red piece of wax. It used to guarantee the authenticity of the msg, but is just smudgy filth now.

The scroll container is still here. It's of thick leather, looks newly made and is open. The Imperial seal on it is broken.

>take piece
You can't see any such thing.

>take wax
Taken.

>i
You are carrying:
  a wax

* * *

>o cylinder
Sorry, that can't be corrected.

>open cylinder
You open the scroll container, revealing a letter.

>read message
Letter text here...

The carriage is finally slowing down, and halts suddenly. You have arrived.

It's time to perform the role of your life. You couldn't believe it when it happened: The huge honour, to be chosen for the task at hand. This would surely be the single most important assignment you could have dreamt of ever getting.
You memorise the content of the letter and make sure to carefully tear it into tiny random pieces. As you open the door you discard them in the evening breez while stepping down onto the sand. The carriage takes its leave.

Yard
You have never witnessed such a marvelous garden before.

* * *

>open
(the scroll container)
 The carriage is finally beginning to slow down as you reach for the scroll container. You hesitate a moment, as if it wasn't meant for youm but you know it is. It was placed there by trusted messenger, the word directly sent from the cour of his highness.
 You think about it for a second and realise you stopped for a moment not because you would violate the law of secrecy by resting eyes where they didn't belong, but because you knew how important the content of the container was.

>look
carriage
 It's pitch black construction is heavily decoareted with flower resembling golden patterns, it is spatious and of finest standard in every aspect. There are two comfortable wide seats that face each other in it, one of which you occupy. The carriage walls are covered with quilted dark red silk. The door is locked from the outside.

You notice a scroll container lying at the empty seat in front of you.  It's of thick leather, looks newly made and is open. The Imperial seal on it is broken.

>look at container
It gives an impression of being important due to it wearing the wax sealing with the Imperial sigill. Rumor has it only the emperor, his nearest of kin and a few selected advisors are authorised to use it. The container is of good craftmanship. It has a cylindrical shape made of just a single piece of leather to better protect its content in case it would be exposed to water. 

In the scroll container is a letter.

>read the letter
Your mission is... Letter text here...

The horses have halted. You have arrived.

It's time to perform the role of your life. You couldn't believe it when it happened: The huge honour, to be chosen for the task at hand. This would surely be the single most important assignment you could have dreamt of ever getting.
You memorise the content of the letter and make sure to carefully tear it into tiny random pieces beyond recognition. As you open the door you discard them in the evening breez while stepping down onto the sand. The carriage takes its leave.

Yard
Three fountains in a row.

>i
You are carrying nothing.

>help
 > Introduction to WTLore
   Instructions for Play
   Hints
   Settings
   Contacting the author

* * *

 > Introduction to WTLore
   Instructions for Play
   Hints
   Settings
   Contacting the author
 > Introduction to WTLore
   Instructions for Play
   Hints
   Settings
   Contacting the author

Yard
Three fountains in a row.

* * *

>o tube
Sorry, that can't be corrected.

>open tube
The carriage is finally beginning to slow down as you reach for the scroll container. You hesitate a moment, as if it wasn't meant for you but you know it is. It was placed there by trusted messenger, the word directly sent from the court of his Imperial highness. 

You think about it for a second and realise you stopped for a moment not because you would violate the law of secrecy by resting eyes where they didn't belong, but because you know how important the content of the container is.

Your orders are in the container, waiting to be read.

>close tube
There's no use closing it now that the sigill on it has been broken into several pieces.

* * *

>test wax
(Testing.)

>[1] l
carriage
It's pitch black construction is h avily decoareted with flower resembling golden patterns, it is spatious and of finest standard in every aspect. There are two comfortable wide seats that face each other in it, one of which you occupy. The carriage walls are covered with quilted dark red silk. The door is locked from the outside.

The scroll container is still here. It's of thick leather, looks newly made and hasn't been opened yet judging by the looks of the unbroken seal. 

You're bored by the long travels and have a tense feeling.

>[2] open scroll container
The carriage is finally beginning to slow down as you reach for the scroll container. The broken wax falls of it in small pieces on the seat. Seeing this, you hesitate a moment, as if the container wasn't meant for you even though you know it is. It was placed there by trusted messenger, the word directly sent from the court of his Imperial highness. 

You think about it for a second and realise you stopped for a moment not because you would violate the law of secrecy by resting eyes where they didn't belong, but because you know how important the content of the container is.

Your orders are in the container, waiting to be read.

>[3] l
carriage
It's pitch black construction is h avily decoareted with flower resembling golden patterns, it is spatious and of finest standard in every aspect. There are two comfortable wide seats that face each other in it, one of which you occupy. The carriage walls are covered with quilted dark red silk. The door is locked from the outside.

On the seat there are some small red piece of wax. They used to guarantee the authenticity of the message it sealed.

The scroll container is still here. It's of thick leather, looks newly made and is open.

>[4] take emblem
Taken.

>[5] drop emblem
Dropped.

>[6] take sigill
Taken.

>[7] i
You are carrying:
  some pieces of wax

* * *

>examine container
It gives an impression of being important due to it wearing the wax sealing with the Imperial sigill. Rumor has it only the emperor, his nearest of kin and a few selected advisors are authorised to use it. The container is of good craftmanship. It has a cylindrical shape made of just a single piece of leather to better protect its content in case it would be exposed to water.

>open container
The carriage is finally beginning to slow down as you reach for the scroll container. The broken wax falls of it in small pieces on the seat. Seeing this, you hesitate a moment, as if the container wasn't meant for you even though you know it is. It was placed there by trusted messenger, the word directly sent from the court of his Imperial highness. 

You think about it for a second and realise you stopped for a moment not because you would violate the law of secrecy by resting eyes where they didn't belong, but because you know how important the content of the container is.

Your orders are in the container, waiting to be read.

>look container
It gives an impression of being important due to it having worn the sigill. Rumor has it only the emperor, his nearest of kin and a few selected advisors are authorised to use it.

In the scroll container is a letter.